








111111111
100010EC1
1100000C1
111100001
100000001
100000001
1P0000001
111111111









