11111111111111
1C0000C0010001
10P00000010001
10C000E0010001
1000000V000C01
11111111111111
