1111111111111111
1CCCCCCCCCCCCCC1
1CCCCCCCCCCCCCC1
1CCCCCCCCCCCCCC1
1CCCCPCCCECCCCC1
1CCCCCCCCCCCCCC1
1CCCCCCCCCCCCCC1
1CCCCCCCCCCCCCC1
1CCCCCCCCCCCCCC1
1111111111111111

















